211111111111111111111111111111111112
100000000000000000000000000000000001
100000001000000001000000000100000001
100000112110000112110000011211000001
100000001000000001000000000100000001
100000000000000000000000000000000001
100000000000000000000000000000000001
100000001000000001000000000100000001
100000112110000112110000011211000001
100000001000000001000000000100000001
100000000000000000000000000000000001
100000000000000000000000000000000001
100000001000000001000000000100000001
100000112110000112110000011211000001
100000001000000001000000000100000001
100000000000000000000000000000000001
100000000000000000000000000000000001
100000001000000001000000000100000001
100000112110000112110000011211000001
100000001000000001000000000100000001
100000000000000000000000000000000001
100000000000000000000000000000000001
100000001000000001000000000100000001
100000112110000112110000011211000001
100000001000000001000000000100000001
100000000000000000000000000000000001
100000000000000000000000000000000001
100000001000000001000000000100000001
100000112110000112110000011211000001
100000001000000001000000000100000001
100000000000000000000000000000000001
100000001000000001000000000100000001
100000112110000112110000011211000001
100000001000000001000000000100000001
100000000000000000000000000000000001
211111111111111111111111111111111112 