211121112112211121112221111111122112
100010001001100010001110000000011001
101000101100000111000100101111010012
101000100011100000010010000011001012
101010010000000110001000110111100001
100100121110010000011111000001010101
210101010001110110000100011001000101
100101000100000100110111000012101001
101000010010010001001000011001000101
100010121001001000000011100100011001
211110010111011101110111001010000001
100100000000000001000001000000110112
101001100111011101110111000100010001
101100100001001000010101010011000101
100100111001111010010001000011101112
210111100101001000011100011001000101
100000100000011001110001000100110001
101110110111000100000110011000100101
101010010000011001011011122101111001
100010100110100010010010011100100012
210110010110001111001000000011001001
100100010001000100101011111000011101
100111011001011001100000001001100101
100000000110000100111001110010000001
211111000010101001000101001000111101
100011101000010000010011010100010001
101000100101011011110110000010121101
101110000101001010010100101000010001
100001011001001110100110000111010112
211101000011000000001000110000010001
100101100110011110011011001011011101
210000001001000100001000011000010001
100111001110011101100011000011010112
210101000010010000110110010111110112
100001110000000010000000010000000001
211112220111111121111111121111111112